###################################################################################################
#                                                                                        #        #
#     #################################################################################  #        #
#     #                                                                               #  #        #
#     #      ###################################################################      #  #        #
#     #      #                                                                 #      #  ####     #
#     #      #                                                                 #      #     #     #
#     #  %   #                                                                 #      #     #     #
#     #      #                                                                                    #
#     #      #                                                                 #      #     #     #
#     #      #                    ################################             #      #     #     #
#     #      #                    #    .                  .      #             #      #     #     #
#     #      #                    #    '.' ,.. .^.....^.'.'      #             #      #     #     #
#     #      #                    #      '.   <>  <>   .'        #             #      #     #     #
#     #      #                    #       ,  (\;";";/) ,         #             #      #     #     #
#     #      #                    #       '. .~^~~^~. .'         #             #      #     #     #
#     #      #                    #         '         '          #             #      #     #     #
#     #      #                                   P               #             #      #     #     #
#     #      #                    ################################             #      #     #     #
#     #      #                                                                 #      #     #     #
#     #      #                                                                 #      #     #     #
#     #      #                                                                 #      #     #     #
#     #      #                                                                 #      #     #     #
#     #      #                                                                        #     #     #
#     #      #                                                                        #     #     #
#     #      ##########################################################################     #     #
#     #                                                                                     #     #
#     #######################################################################################     #
#                                                                                                 #
###################################################################################################
