###################################################################################################
# %                    +                     #  %              *  #     %                 % !     #
#                                            #                    #                               #
#  !    ##############################       #        #############################       #       #
#  0         !    #          %       #       #        #                           #       #       #
#          !      #                  #     % #        #        &                  #       #   & ! #
#     ####        #       ######     #       #        #      #                    #       #########
#        #                #  +       #       #        #      ###############      #               #
#        #                #          #       #        #           #               #               #
#    #####        #########          #       #        # %         #               #               #
#        #        #            #######      ##        #####       #       ################      ###
#        #        #         ####                      %   #       #                    + #        #
#      * #        #         #                             #       #    %                 #        #
##########        ################################        #       #                      #        #
#                      !                       % #        #       ################       #  %     #
#    %!%                                 ####    #        #                      #       ####     #
##############     ###############       ####    #        #                      #       #        #
#       &    #     #                             #        #                      #       #        #
#            #     #   +                         #        #       ##########     #  %    #     ####
#            #     ######       ############     #        #       #              #       #        #
####    ######                  #     *    #     #        #       #  &           #       #        #
#                               #          #     #        #       #              #       #        #
#   *                           #          #     #        #       #########      #       ####     #
#################################          #     #        #               #      #          #     #
#    %                             !             #        #               #      #          #     #
#                                                #        #               #      ######           #
###########       ################################        #########       #           #           #
# %                                        &  #               !           #           #           #
#    *                                        #                           #           #        +  #
###################################################################################################
