###################################################################################################
#                                            #   *                #                               #
#                                            #                    #                               #
#       ##############################       #        #############################       #       #
# 0               #                  #       #        #                           #       #       #
#                 #                  #       #        #        &                  #       #   &   #
#     ####        #       ######     #       #        #      #                    #       #########
#        #             %  #  +       #       #        #      ###############      #               #
#        #                #          #       #        #           #               #               #
#    #####        #########          #       #        #           #               #               #
#        #        #            #######      ##        #####       #       ################      ###
#        #        #         ####                          #       #                    + #        #
#      * #        #         #                             #       #                      #        #
##########        ################################        #       #   %                  #        #
#                                                #        #       ################       #        #
#                                        ####    #        #                      #       ####     #
##############     ###############       ####    #        #           *          #       #        #
#            #     #                             #        #                      #       #        #
#            #     #   +                         #        #       ##########     #       #     ####
#            #     ######       ############     #        #       #              #       #        #
####    ######                  #          #     #        #       #  &           #       #        #
#                               #     %    #     #        #       #              #       #        #
#   *                           #          #     #        #       #########      #       ####     #
#################################          #     #        #               #      #          #     #
#                                                #        #               #      #          #     #
#                                                #        #               #      ######           #
###########       ################################        #########       #           #           #
#                                          &  #                           #           #           #
#    *                                        #                           #           #        +  #
###################################################################################################
