###################################################################################################
#     0 #                                                         #       #                       #
#       #                                                         #       ############            #
#       #        #######      ################        #####       #                  #      #     #
#       #              #      #                       #           #                  #      #     #
#       #              #      #                       #       #################      #      #     #
#       ################      #        #########      #       #      #        #      #      #     #
#                             #        #       #      #       #      #        #      #      #     #
#                             #        #       #      #       #      #        #      #      #     #
###############################        #       #      #       #      #        #      #      #     #
#                                                     #       #      #        #      #      #     #
#                                                     #       #      #        #      #      #     #
###################################       #############       #      #        #      #      #     #
#                                 #       #                   #      #               #      #######
#                                 #       #                   #      #               #      #     #
###################       #########       #############       #      #        #      #      #     #
#                                                                    #        #      #      #     #
#                                                                    #        #      #            #
###############################         ##############################        #      #            #
#                             #                                               #      #            #
#                              #                                              #      #      #     #
#######################       # ##################      #######################      #      #     #
#                     #       #                  #      #                            #      #     #
#            #        #       #                  #      #######       #              #      #     #
#            #        #       #       ############            #       ################      #     #
#            #                        #                       #       #                     #     #
##############                        ##################      #       #######################     #
#                     #       #                               #                                   #
#                     #       #                               #                                   #
###################################################################################################
