###################################################################################################
#                                            #                    #                               #
#                                            #                    #                               #
#       ##############################       #        #############################       #       #                                              
#                 #                  #       #        #                           #       #       #    
#                 #                  #       #        #                           #       #       #     
#     ####        #       ######     #       #        #      #                    #       #########   
#        #                #          #       #        #      ###############      #               #               
#        #                #          #       #        #           #               #               #   
#    #####        #########          #       #        #           #               #               #                      
#        #        #            #######      ##        #####       #       ################      ###                                 
#        #        #         ####                          #       #                      #        #        
#        #        #         #                             #       #                      #        #      
##########        ################################        #       #                      #        #                           
#                                                #        #       ################       #        #                   
#                                        ####    #        #                      #       ####     #     
##############     ###############       ####    #        #                      #       #        #                               
#            #     #                             #        #                      #       #        #       
#            #     #                             #        #       ##########     #       #     ####                    
#            #     ######       ############     #        #       #              #       #        #                   
####    ######                  #          #     #        #       #              #       #        #    
#                               #          #     #        #       #              #       #        #         
#                               #          #     #        #       #########      #       ####     #                 
#################################          #     #        #               #      #          #     #                                      
#                                                #        #               #      #          #     #       
#                                                #        #               #      ######           #          
###########       ################################        #########       #           #           #                                             
#                                             #                           #           #           #   
#                                             #                           #           #           #    
####################################################################################################