###################################################################################################
#      1#                                 %                       #       #                     & #
#       #                                                         #       ############            #
#       #        #######      ################        #####       #                  #      #     #
#       #              #      #                       #           #                  #      #     #
#       #          &   #      #                       #       #################      #      #     #
#       ################  %   #        #########      #  %    #      #     *  #      #      #     #
#     %                       #        #   *   #      #       #      #        #      #      #     #
#                             #        #       #      #       #      #        #      #      #     #
###############################        #       #      #       #      #        #      #      #     #
#  +            %                                     #       #      #        #      #      #     #
#                                                     #       #      #        #      #      #     #
###################################       #############       #      #        #      #      #     #
#                                 #       #  &                #      #               #      #######
#  +                         %    #       #                   #      #               #      #     #
###################       #########       #############       #      #        #      #      #  %  #
#                                                                    #        #      #      #     #
#  &                                                  %           *  #        #      #            #
###############################         ##############################        #      #            #
#                             #                               %               #      #            #
#     %                       #                                               #      #      #     #
#######################       # ##################      #######################      #      #     #
#                     #       #                  #      #                            #      #     #
#            #        #       #               +  #      #######       #   %          #      #     #
#   &        #        #       #       ############            #       ################      #     #
#            #                        #                       #       #    +                #     #
##############                        ##################      #       #######################  %  #
#  *                  #       #                  %            #                                   #
#                  %  #       #                               #   +                               #
###################################################################################################
