###################################################################################################
#     1 #                                                         #       #                     & #
#       #                                                         #       ############            #
#       #        #######      ################        #####       #                  #      #     #
#       #              #      #                       #           #                  #      #     #
#       #          &   #      #                       #       #################      #      #     #
#       ################  %   #        #########      #       #      #     *  #      #      #     #
#                             #        #   *   #      #       #      #        #      #      #     #
#                             #        #       #      #       #      #        #      #      #     #
###############################        #       #      #       #      #        #      #      #     #
#  +                                                  #       #      #        #      #      #     #
#                                                     #       #      #        #      #      #     #
###################################       #############       #      #        #      #      #     #
#                                 #       #  &                #      #               #      #######
#  +                              #       #                   #      #               #      #     #
###################       #########       #############       #      #        #      #      #  %  #
#                                                                    #        #      #      #     #
#  &                                                              *  #        #      #            #
###############################         ##############################        #      #            #
#                             #                                               #      #            #
#                             #                                               #      #      #     #
#######################       # ##################      #######################      #      #     #
#                     #       #                  #      #                            #      #     #
#            #        #       #               +  #      #######       #              #      #     #
#   &        #        #       #       ############            #       ################      #     #
#            #                        #                       #       #    +                #     #
##############                        ##################      #       #######################     #
#  *                  #       #                               #                                   #
#                     #       #                               #   +                               #
###################################################################################################
