###################################################################################################
#  %   1#     !  %                       !%                       #       #  L                  &!#
#      !#                                                         #       ############            #
#       #        #######      ################        #####       #                  #      #     #
#   %   #              #      #   %                   #           #                  #      #     #
#       #          &   #      #                       #  !    #################      #      #     #
#       ################  %   #        #########      #  %    #      #     *  #      #      #     #
#     %                       #        #   *   #      #       #   %  #        #      #      #     #
#                             #        #   !   #      #       #      #        #      #      #     #
###############################        #       #      #       #      #        #      #      #     #
# !+            %                                     #       #      #        #      #      #     #
#                                                     #       #      #     %  #      #      #     #
###################################       #############       #      #        #      #      #     #
#                %                #       #                   #      #               #      #######
#  +                         %!   #       #  %                #      #               #      #  !  #
###################       #########       #############       #      #        #      #      #  %  #
#                                                                    #        #      #      #     #
#  &                                                  %           *  #        #      #            #
###############################         ##############################        #      #            #
#                             #                               %               #      #            #
#     %                       #                                               #      #      #     #
#######################       # ##################      #######################      #      #     #
#                 %   #       #                  #      #                            #      #     #
#            #        #       #               + !#      #######       #   %          #      #     #
#  !&        #        #       #       ############            #       ################      #     #
#            #                        #                       #       # % !+                #     #
##############                        ##################      #       #######################  %  #
# %*                  #       #                  %            #                                   #
#               !  %  #       #                               #   +                               #
###################################################################################################
